$$$$$$$$$$$$$$$$$
$   $   $       $
$ $ $ $ $ $$$$$ $
$ $ $ $ $ $   $ $
$ $ $ $$$ $ $ $ $
$ $ $   $ $ $   $
$ $ $ $ $ $ $$$$$
$ $ $ $ $t$   $ $
$ $$$ $ $$$ $ $ $
$     $     $ $ $
$ $$$ $ $$$ $ $ $
$ $   $ $   $   $
$$$ $$$$$ $$$ $ $
$   $         $ $
$ $$$ $$$$$$$$$ $
$   s           $
$$$$$$$$$$$$$$$$$
